WWWWWWWWWWWWWWWWWWWWWWW
W  S WW WWW     W    WW
WWWW WW WW  W W WWWW WW
WWWW W   WW WWW  K    W
W T    W WW W WWWWWW WW
W WW W W  W L W  WW   W
W   WWWWW   W WW WW   W
W WW     WWWW WW    WWW
W     WW WWWW U  WW WWW
W WWW W       WW WW   W
WWWWWWWWWWWWWWWWWWWWWWW