   W             
 WWEWW           
W     W          
W TTT W
W     W          
 WWLWW WWWWWW    
W     W  TT  WW  
W TTT W        W 
W TTT U  TTT   KW
W TTT W        W 
W     W  TT  WW  
 WWUWW WWWWWW    
W     W          
W  S  W
W     W
 WWWWW